1111100000011111
1000000000000001
1000000000000001
1000000000000001
1000000000000001
1000111111110001
1000000000000001
1000000000000001
1111100000011111
1000000000000001
1000000000000001
1000111111110001
1000000000000001
1000000000000001
1111100000011111
1111111001111111
